Team,,W,L,T,W-L%,PF,PA,PD,MoV,SoS,SRS,OSRS,DSRS,Last_Season_W,Last_Season_L,Last_Season_T,Last_Season_PF,Last_Season_PA,Last_Season_PD
Arizona Cardinals,2019,5,10,1,0.344,361,442,-81,-5.1,1.8,-3.2,-0.3,-2.9,3,13,0,225,425,-200
Atlanta Falcons,2019,7,9,0,0.438,381,399,-18,-1.1,1.1,-0.1,0.3,-0.4,7,9,0,414,423,-9
Baltimore Ravens,2019,14,2,0,0.875,531,282,249,15.6,0.1,15.6,11,4.7,10,6,0,389,287,102
Buffalo Bills,2019,10,6,0,0.625,314,259,55,3.4,-1.3,2.2,-3.5,5.7,6,10,0,269,374,-105
Carolina Panthers,2019,5,11,0,0.313,340,470,-130,-8.1,1.1,-7,-1.9,-5.1,7,9,0,376,382,-6
Chicago Bears,2019,8,8,0,0.5,280,298,-18,-1.1,0.2,-0.9,-5.4,4.5,12,4,0,421,283,138
Cincinnati Bengals,2019,2,14,0,0.125,279,420,-141,-8.8,1.5,-7.3,-4.4,-2.9,6,10,0,368,455,-87
Cleveland Browns,2019,6,10,0,0.375,335,393,-58,-3.6,1.7,-1.9,-0.4,-1.5,7,8,1,359,392,-33
Dallas Cowboys,2019,8,8,0,0.5,434,321,113,7.1,-1.8,5.3,3.8,1.5,10,6,0,339,324,15
Denver Broncos,2019,7,9,0,0.438,282,316,-34,-2.1,0,-2.1,-4.8,2.7,6,10,0,329,349,-20
Detroit Lions,2019,3,12,1,0.219,341,423,-82,-5.1,-0.1,-5.2,-1.2,-4,6,10,0,324,360,-36
Green Bay Packers,2019,13,3,0,0.813,376,313,63,3.9,-0.7,3.2,0.6,2.6,6,9,1,376,400,-24
Houston Texans,2019,10,6,0,0.625,378,385,-7,-0.4,1,0.5,1,-0.5,11,5,0,402,316,86
Indianapolis Colts,2019,7,9,0,0.438,361,373,-12,-0.8,-1.1,-1.8,-1,-0.8,10,6,0,433,344,89
Jacksonville Jaguars,2019,6,10,0,0.375,300,397,-97,-6.1,-0.6,-6.7,-4.6,-2.1,5,11,0,245,316,-71
Kansas City Chiefs,2019,12,4,0,0.75,451,308,143,8.9,0.2,9.1,6.2,2.9,12,4,0,565,421,144
Miami Dolphins,2019,5,11,0,0.313,306,494,-188,-11.8,0.2,-11.6,-2.4,-9.1,7,9,0,319,433,-114
Minnesota Vikings,2019,10,6,0,0.625,407,303,104,6.5,-1.1,5.4,2.5,2.9,8,7,1,360,341,19
New England Patriots,2019,12,4,0,0.75,420,225,195,12.2,-1.8,10.4,2.8,7.6,11,5,0,436,325,111
New Orleans Saints,2019,13,3,0,0.813,458,341,117,7.3,0,7.4,5,2.3,13,3,0,504,353,151
New York Giants,2019,4,12,0,0.25,341,451,-110,-6.9,-1,-7.9,-1.8,-6.1,5,11,0,369,412,-43
New York Jets,2019,7,9,0,0.438,276,359,-83,-5.2,-1.1,-6.3,-5.7,-0.6,4,12,0,333,441,-108
Oakland Raiders,2019,7,9,0,0.438,313,419,-106,-6.6,-0.3,-6.9,-2.5,-4.4,4,12,0,290,467,-177
Philadelphia Eagles,2019,9,7,0,0.563,385,354,31,1.9,-1.7,0.3,0.7,-0.4,9,7,0,367,348,19
Pittsburgh Steelers,2019,8,8,0,0.5,289,303,-14,-0.9,1.2,0.3,-4.3,4.6,9,6,1,428,360,68
San Diego Chargers,2019,5,11,0,0.313,337,345,-8,-0.5,-0.8,-1.3,-1.6,0.3,12,4,0,428,329,99
San Francisco 49ers,2019,13,3,0,0.813,479,310,169,10.6,0.4,11,6.7,4.3,4,12,0,342,435,-93
Seattle Seahawks,2019,11,5,0,0.688,405,398,7,0.4,2.3,2.7,2.9,-0.2,10,6,0,428,347,81
St. Louis Rams,2019,9,7,0,0.563,394,364,30,1.9,2,3.9,2.2,1.7,13,3,0,527,384,143
Tampa Bay Buccaneers,2019,7,9,0,0.438,458,449,9,0.6,-0.2,0.4,4.9,-4.5,5,11,0,396,464,-68
Tennessee Titans,2019,9,7,0,0.563,402,331,71,4.4,-1,3.4,1.8,1.7,9,7,0,310,303,7
Washington Redskins,2019,3,13,0,0.188,266,435,-169,-10.6,-0.2,-10.8,-6.3,-4.5,7,9,0,281,359,-78
Arizona Cardinals,2018,3,13,0,0.188,225,425,-200,-12.5,1,-11.5,-9.6,-1.9,8,8,0,295,361,-66
Atlanta Falcons,2018,7,9,0,0.438,414,423,-9,-0.6,0.4,-0.1,2.5,-2.6,10,6,0,353,315,38
Baltimore Ravens,2018,10,6,0,0.625,389,287,102,6.4,0.6,7,0.6,6.4,9,7,0,395,303,92
Buffalo Bills,2018,6,10,0,0.375,269,374,-105,-6.6,-0.3,-6.9,-6.3,-0.6,9,7,0,302,359,-57
Carolina Panthers,2018,7,9,0,0.438,376,382,-6,-0.4,1.3,0.9,0.1,0.8,11,5,0,363,327,36
Chicago Bears,2018,12,4,0,0.75,421,283,138,8.6,-2.3,6.3,1.5,4.8,5,11,0,264,320,-56
Cincinnati Bengals,2018,6,10,0,0.375,368,455,-87,-5.4,2,-3.4,0,-3.4,7,9,0,290,349,-59
Cleveland Browns,2018,7,8,1,0.469,359,392,-33,-2.1,1.7,-0.3,-1,0.6,0,16,0,234,410,-176
Dallas Cowboys,2018,10,6,0,0.625,339,324,15,0.9,0.2,1.1,-1.9,2.9,9,7,0,354,332,22
Denver Broncos,2018,6,10,0,0.375,329,349,-20,-1.3,0.7,-0.5,-3.6,3.1,5,11,0,289,382,-93
Detroit Lions,2018,6,10,0,0.375,324,360,-36,-2.3,-0.8,-3,-3.3,0.3,9,7,0,410,376,34
Green Bay Packers,2018,6,9,1,0.406,376,400,-24,-1.5,-1.2,-2.7,0,-2.7,7,9,0,320,384,-64
Houston Texans,2018,11,5,0,0.688,402,316,86,5.4,-1.5,3.8,2.4,1.4,4,12,0,338,436,-98
Indianapolis Colts,2018,10,6,0,0.625,433,344,89,5.6,-2.2,3.4,3.9,-0.6,4,12,0,263,404,-141
Jacksonville Jaguars,2018,5,11,0,0.313,245,316,-71,-4.4,0.4,-4,-8.1,4,10,6,0,417,268,149
Kansas City Chiefs,2018,12,4,0,0.75,565,421,144,9,-0.1,8.9,12.6,-3.8,10,6,0,415,339,76
Miami Dolphins,2018,7,9,0,0.438,319,433,-114,-7.1,-1.7,-8.8,-3.6,-5.2,6,10,0,281,393,-112
Minnesota Vikings,2018,8,7,1,0.531,360,341,19,1.2,-0.6,0.6,-1.2,1.8,13,3,0,382,252,130
New England Patriots,2018,11,5,0,0.688,436,325,111,6.9,-1.8,5.2,3.1,2.1,13,3,0,458,296,162
New Orleans Saints,2018,13,3,0,0.813,504,353,151,9.4,0.6,10.1,7.9,2.2,11,5,0,448,326,122
New York Giants,2018,5,11,0,0.313,369,412,-43,-2.7,0.5,-2.2,0.8,-2.9,3,13,0,246,388,-142
New York Jets,2018,4,12,0,0.25,333,441,-108,-6.8,-1.1,-7.8,-2,-5.9,5,11,0,298,382,-84
Oakland Raiders,2018,4,12,0,0.25,290,467,-177,-11.1,1.8,-9.3,-5.2,-4.1,6,10,0,301,373,-72
Philadelphia Eagles,2018,9,7,0,0.563,367,348,19,1.2,0.5,1.7,0,1.8,13,3,0,457,295,162
Pittsburgh Steelers,2018,9,6,1,0.594,428,360,68,4.3,1.3,5.6,3.9,1.7,13,3,0,406,308,98
San Diego Chargers,2018,12,4,0,0.75,428,329,99,6.2,-0.2,6,3,2.9,9,7,0,355,272,83
San Francisco 49ers,2018,4,12,0,0.25,342,435,-93,-5.8,0.3,-5.5,-2.5,-3.1,6,10,0,331,383,-52
Seattle Seahawks,2018,10,6,0,0.625,428,347,81,5.1,-0.6,4.5,3,1.5,9,7,0,366,332,34
St. Louis Rams,2018,13,3,0,0.813,527,384,143,8.9,-0.4,8.5,9.5,-1.1,11,5,0,478,329,149
Tampa Bay Buccaneers,2018,5,11,0,0.313,396,464,-68,-4.3,1.7,-2.6,2,-4.6,5,11,0,335,382,-47
Tennessee Titans,2018,9,7,0,0.563,310,303,7,0.4,-0.2,0.2,-3.2,3.5,9,7,0,334,356,-22
Washington Redskins,2018,7,9,0,0.438,281,359,-78,-4.9,-0.1,-4.9,-5.6,0.6,7,9,0,342,388,-46
Arizona Cardinals,2017,8,8,0,0.5,295,361,-66,-4.1,0.4,-3.7,-4,0.2,7,8,1,418,362,56
Atlanta Falcons,2017,10,6,0,0.625,353,315,38,2.4,1.9,4.3,1.1,3.2,11,5,0,540,406,134
Baltimore Ravens,2017,9,7,0,0.563,395,303,92,5.8,-2.4,3.4,2.2,1.2,8,8,0,343,321,22
Buffalo Bills,2017,9,7,0,0.563,302,359,-57,-3.6,-0.5,-4,-3,-1,7,9,0,399,378,21
Carolina Panthers,2017,11,5,0,0.688,363,327,36,2.3,2.1,4.3,1.7,2.7,6,10,0,369,402,-33
Chicago Bears,2017,5,11,0,0.313,264,320,-56,-3.5,2.2,-1.3,-4.6,3.3,3,13,0,279,399,-120
Cincinnati Bengals,2017,7,9,0,0.438,290,349,-59,-3.7,-1.3,-5,-4.1,-0.9,6,9,1,325,315,10
Cleveland Browns,2017,0,16,0,0,234,410,-176,-11,0,-11,-6.8,-4.1,1,15,0,264,452,-188
Dallas Cowboys,2017,9,7,0,0.563,354,332,22,1.4,0.2,1.6,0.4,1.2,13,3,0,421,306,115
Denver Broncos,2017,5,11,0,0.313,289,382,-93,-5.8,-0.9,-6.7,-3.9,-2.9,9,7,0,333,297,36
Detroit Lions,2017,9,7,0,0.563,410,376,34,2.1,0.6,2.7,5.2,-2.5,9,7,0,346,358,-12
Green Bay Packers,2017,7,9,0,0.438,320,384,-64,-4,2.1,-1.9,-0.3,-1.6,10,6,0,432,388,44
Houston Texans,2017,4,12,0,0.25,338,436,-98,-6.1,-0.3,-6.4,-0.8,-5.6,9,7,0,279,328,-49
Indianapolis Colts,2017,4,12,0,0.25,263,404,-141,-8.8,-1.3,-10.1,-6.1,-4,8,8,0,411,392,19
Jacksonville Jaguars,2017,10,6,0,0.625,417,268,149,9.3,-2.8,6.5,3,3.6,3,13,0,318,400,-82
Kansas City Chiefs,2017,10,6,0,0.625,415,339,76,4.8,-1.3,3.4,3.8,-0.3,12,4,0,389,311,78
Miami Dolphins,2017,6,10,0,0.375,281,393,-112,-7,0.7,-6.3,-3.9,-2.4,10,6,0,363,380,-17
Minnesota Vikings,2017,13,3,0,0.813,382,252,130,8.1,1,9.1,2.3,6.8,8,8,0,327,307,20
New England Patriots,2017,13,3,0,0.813,458,296,162,10.1,-1.2,8.9,6.3,2.6,14,2,0,441,250,191
New Orleans Saints,2017,11,5,0,0.688,448,326,122,7.6,1.5,9.2,7,2.2,7,9,0,469,454,15
New York Giants,2017,3,13,0,0.188,246,388,-142,-8.9,1.3,-7.6,-6.4,-1.2,11,5,0,310,284,26
New York Jets,2017,5,11,0,0.313,298,382,-84,-5.3,0.3,-4.9,-2.9,-2.1,5,11,0,275,409,-134
Oakland Raiders,2017,6,10,0,0.375,301,373,-72,-4.5,-0.2,-4.7,-3,-1.8,12,4,0,416,385,31
Philadelphia Eagles,2017,13,3,0,0.813,457,295,162,10.1,-0.7,9.4,7,2.5,7,9,0,367,331,36
Pittsburgh Steelers,2017,13,3,0,0.813,406,308,98,6.1,-1.1,5,3.2,1.8,11,5,0,399,327,72
San Diego Chargers,2017,9,7,0,0.563,355,272,83,5.2,-1.5,3.6,-0.3,4,5,11,0,410,423,-13
San Francisco 49ers,2017,6,10,0,0.375,331,383,-52,-3.3,0.4,-2.9,-0.8,-2.1,2,14,0,309,480,-171
Seattle Seahawks,2017,9,7,0,0.563,366,332,34,2.1,-0.2,1.9,0.7,1.2,10,5,1,354,292,62
St. Louis Rams,2017,11,5,0,0.688,478,329,149,9.3,-0.2,9.2,8.2,1,4,12,0,224,394,-170
Tampa Bay Buccaneers,2017,5,11,0,0.313,335,382,-47,-2.9,1.7,-1.3,0.4,-1.7,9,7,0,354,369,-15
Tennessee Titans,2017,9,7,0,0.563,334,356,-22,-1.4,-2.1,-3.5,-2,-1.5,9,7,0,381,378,3
Washington Redskins,2017,7,9,0,0.438,342,388,-46,-2.9,1.6,-1.3,0.5,-1.8,8,7,1,396,383,13
Arizona Cardinals,2016,7,8,1,0.469,418,362,56,3.5,-1.9,1.6,2.4,-0.8,13,3,0,489,313,176
Atlanta Falcons,2016,11,5,0,0.688,540,406,134,8.4,0.1,8.5,10.5,-2,8,8,0,339,345,-6
Baltimore Ravens,2016,8,8,0,0.5,343,321,22,1.4,0.2,1.5,-1.1,2.6,5,11,0,328,401,-73
Buffalo Bills,2016,7,9,0,0.438,399,378,21,1.3,-1.6,-0.3,1.8,-2.2,8,8,0,379,359,20
Carolina Panthers,2016,6,10,0,0.375,369,402,-33,-2.1,1.1,-1,-0.2,-0.8,15,1,0,500,308,192
Chicago Bears,2016,3,13,0,0.188,279,399,-120,-7.5,0,-7.5,-5.2,-2.3,6,10,0,335,397,-62
Cincinnati Bengals,2016,6,9,1,0.406,325,315,10,0.6,0.4,1,-1.5,2.5,12,4,0,419,279,140
Cleveland Browns,2016,1,15,0,0.063,264,452,-188,-11.8,1.7,-10.1,-5.2,-4.9,3,13,0,278,432,-154
Dallas Cowboys,2016,13,3,0,0.813,421,306,115,7.2,-0.2,7,4.1,2.9,4,12,0,275,374,-99
Denver Broncos,2016,9,7,0,0.563,333,297,36,2.3,1.8,4,-2,6.1,12,4,0,355,296,59
Detroit Lions,2016,9,7,0,0.563,346,358,-12,-0.8,-0.6,-1.4,-1.3,-0.1,7,9,0,358,400,-42
Green Bay Packers,2016,10,6,0,0.625,432,388,44,2.8,0.1,2.8,4.9,-2,10,6,0,368,323,45
Houston Texans,2016,9,7,0,0.563,279,328,-49,-3.1,0.4,-2.6,-5.3,2.7,9,7,0,339,313,26
Indianapolis Colts,2016,8,8,0,0.5,411,392,19,1.2,-0.8,0.4,3.1,-2.7,8,8,0,333,408,-75
Jacksonville Jaguars,2016,3,13,0,0.188,318,400,-82,-5.1,0.2,-5,-2.7,-2.3,5,11,0,376,448,-72
Kansas City Chiefs,2016,12,4,0,0.75,389,311,78,4.9,0.7,5.6,1.2,4.4,11,5,0,405,287,118
Miami Dolphins,2016,10,6,0,0.625,363,380,-17,-1.1,-1.3,-2.4,-0.6,-1.8,6,10,0,310,389,-79
Minnesota Vikings,2016,8,8,0,0.5,327,307,20,1.3,-0.3,0.9,-2.6,3.6,11,5,0,365,302,63
New England Patriots,2016,14,2,0,0.875,441,250,191,11.9,-2.7,9.3,4.3,5,12,4,0,465,315,150
New Orleans Saints,2016,7,9,0,0.438,469,454,15,0.9,0.6,1.5,6.8,-5.3,7,9,0,408,476,-68
New York Giants,2016,11,5,0,0.688,310,284,26,1.6,0.5,2.1,-3.2,5.4,6,10,0,420,442,-22
New York Jets,2016,5,11,0,0.313,275,409,-134,-8.4,-0.1,-8.5,-5.5,-3,10,6,0,387,314,73
Oakland Raiders,2016,12,4,0,0.75,416,385,31,1.9,1.3,3.3,3.5,-0.3,7,9,0,359,399,-40
Philadelphia Eagles,2016,7,9,0,0.438,367,331,36,2.3,1.6,3.8,1.3,2.5,7,9,0,377,430,-53
Pittsburgh Steelers,2016,11,5,0,0.688,399,327,72,4.5,0.2,4.7,2.8,2,10,6,0,423,319,104
San Diego Chargers,2016,5,11,0,0.313,410,423,-13,-0.8,0.9,0.1,3,-3,4,12,0,320,398,-78
San Francisco 49ers,2016,2,14,0,0.125,309,480,-171,-10.7,-0.5,-11.2,-3.7,-7.5,5,11,0,238,387,-149
Seattle Seahawks,2016,10,5,1,0.656,354,292,62,3.9,-1.7,2.1,-2.4,4.5,10,6,0,423,277,146
St. Louis Rams,2016,4,12,0,0.25,224,394,-170,-10.6,-0.5,-11.1,-9.5,-1.6,7,9,0,280,330,-50
Tampa Bay Buccaneers,2016,9,7,0,0.563,354,369,-15,-0.9,0.7,-0.2,-1.5,1.3,6,10,0,342,417,-75
Tennessee Titans,2016,9,7,0,0.563,381,378,3,0.2,-1.2,-1,0.7,-1.7,3,13,0,299,423,-124
Washington Redskins,2016,8,7,1,0.531,396,383,13,0.8,1.2,2,3.3,-1.3,9,7,0,388,379,9
Arizona Cardinals,2015,13,3,0,0.813,489,313,176,11,1.3,12.3,9,3.4,11,5,0,310,299,11
Atlanta Falcons,2015,8,8,0,0.5,339,345,-6,-0.4,-3.4,-3.8,-4,0.3,6,10,0,381,417,-36
Baltimore Ravens,2015,5,11,0,0.313,328,401,-73,-4.6,2.6,-1.9,-0.7,-1.2,10,6,0,409,302,107
Buffalo Bills,2015,8,8,0,0.5,379,359,20,1.3,-1.2,0,0.3,-0.2,9,7,0,343,289,54
Carolina Panthers,2015,15,1,0,0.938,500,308,192,12,-3.9,8.1,6,2.1,7,8,1,339,374,-35
Chicago Bears,2015,6,10,0,0.375,335,397,-62,-3.9,2.6,-1.3,-0.1,-1.2,5,11,0,319,442,-123
Cincinnati Bengals,2015,12,4,0,0.75,419,279,140,8.8,1.9,10.6,4.8,5.8,10,5,1,365,344,21
Cleveland Browns,2015,3,13,0,0.188,278,432,-154,-9.6,3.5,-6.1,-3.2,-2.9,7,9,0,299,337,-38
Dallas Cowboys,2015,4,12,0,0.25,275,374,-99,-6.2,-0.7,-6.9,-7,0.1,12,4,0,467,352,115
Denver Broncos,2015,12,4,0,0.75,355,296,59,3.7,2.1,5.8,0.3,5.5,12,4,0,482,354,128
Detroit Lions,2015,7,9,0,0.438,358,400,-42,-2.6,2.4,-0.2,1,-1.3,11,5,0,321,282,39
Green Bay Packers,2015,10,6,0,0.625,368,323,45,2.8,2.5,5.3,2,3.3,12,4,0,486,348,138
Houston Texans,2015,9,7,0,0.563,339,313,26,1.6,-2.4,-0.8,-3.3,2.6,9,7,0,372,307,65
Indianapolis Colts,2015,8,8,0,0.5,333,408,-75,-4.7,-2,-6.7,-3.1,-3.6,11,5,0,458,369,89
Jacksonville Jaguars,2015,5,11,0,0.313,376,448,-72,-4.5,-3,-7.5,-0.7,-6.9,3,13,0,249,412,-163
Kansas City Chiefs,2015,11,5,0,0.688,405,287,118,7.4,1.6,9,3.7,5.3,9,7,0,353,281,72
Miami Dolphins,2015,6,10,0,0.375,310,389,-79,-4.9,-1.9,-6.8,-4.7,-2.2,8,8,0,388,373,15
Minnesota Vikings,2015,11,5,0,0.688,365,302,63,3.9,1.9,5.8,1.1,4.7,7,9,0,325,343,-18
New England Patriots,2015,12,4,0,0.75,465,315,150,9.4,-2.4,7,5.3,1.7,12,4,0,468,313,155
New Orleans Saints,2015,7,9,0,0.438,408,476,-68,-4.3,-2.3,-6.6,1.1,-7.6,7,9,0,401,424,-23
New York Giants,2015,6,10,0,0.375,420,442,-22,-1.4,-2.2,-3.6,2.5,-6.1,6,10,0,380,400,-20
New York Jets,2015,10,6,0,0.625,387,314,73,4.6,-3,1.5,-0.5,2,4,12,0,283,401,-118
Oakland Raiders,2015,7,9,0,0.438,359,399,-40,-2.5,2.3,-0.2,1.4,-1.6,10,6,0,474,400,74
Philadelphia Eagles,2015,7,9,0,0.438,377,430,-53,-3.3,-1.3,-4.6,-0.6,-4,11,5,0,436,368,68
Pittsburgh Steelers,2015,10,6,0,0.625,423,319,104,6.5,2.2,8.7,5.1,3.6,9,7,0,348,348,0
San Diego Chargers,2015,4,12,0,0.25,320,398,-78,-4.9,2.2,-2.6,-1.5,-1.1,8,8,0,306,340,-34
San Francisco 49ers,2015,5,11,0,0.313,238,387,-149,-9.3,3.8,-5.5,-6,0.5,12,4,0,394,254,140
Seattle Seahawks,2015,10,6,0,0.625,423,277,146,9.1,2.2,11.3,5.4,6,6,10,0,324,354,-30
St. Louis Rams,2015,7,9,0,0.438,280,330,-50,-3.1,3,-0.2,-3.8,3.6,2,14,0,277,410,-133
Tampa Bay Buccaneers,2015,6,10,0,0.375,342,417,-75,-4.7,-3,-7.7,-3.5,-4.2,2,14,0,254,438,-184
Tennessee Titans,2015,3,13,0,0.188,299,423,-124,-7.8,-2.8,-10.5,-5.9,-4.6,4,12,0,301,438,-137
Washington Redskins,2015,9,7,0,0.563,388,379,9,0.6,-2.5,-1.9,-0.2,-1.8,10,6,0,379,324,55
Arizona Cardinals,2014,11,5,0,0.688,310,299,11,0.7,1.3,2,-2.4,4.4,4,12,0,353,443,-90
Atlanta Falcons,2014,6,10,0,0.375,381,417,-36,-2.3,-1.6,-3.8,0.6,-4.4,8,8,0,320,352,-32
Baltimore Ravens,2014,10,6,0,0.625,409,302,107,6.7,-2.1,4.6,1.8,2.8,6,10,0,339,388,-49
Buffalo Bills,2014,9,7,0,0.563,343,289,54,3.4,1.6,4.9,-0.4,5.3,12,4,0,366,241,125
Carolina Panthers,2014,7,8,1,0.469,339,374,-35,-2.2,-0.9,-3.1,-2.4,-0.7,8,8,0,445,478,-33
Chicago Bears,2014,5,11,0,0.313,319,442,-123,-7.7,1,-6.7,-2,-4.7,11,5,0,430,305,125
Cincinnati Bengals,2014,10,5,1,0.656,365,344,21,1.3,-0.6,0.7,-0.5,1.3,4,12,0,308,406,-98
Cleveland Browns,2014,7,9,0,0.438,299,337,-38,-2.4,-1.5,-3.9,-4.8,0.9,8,8,0,439,432,7
Dallas Cowboys,2014,12,4,0,0.75,467,352,115,7.2,-1.8,5.4,5.3,0.1,13,3,0,606,399,207
Denver Broncos,2014,12,4,0,0.75,482,354,128,8,1.6,9.6,9.2,0.4,7,9,0,395,376,19
Detroit Lions,2014,11,5,0,0.688,321,282,39,2.4,-0.4,2.1,-3.2,5.2,8,7,1,417,428,-11
Green Bay Packers,2014,12,4,0,0.75,486,348,138,8.6,-0.3,8.3,7.9,0.4,2,14,0,276,428,-152
Houston Texans,2014,9,7,0,0.563,372,307,65,4.1,-2.3,1.7,-0.8,2.5,11,5,0,391,336,55
Indianapolis Colts,2014,11,5,0,0.688,458,369,89,5.6,-1.1,4.4,5.2,-0.8,4,12,0,247,449,-202
Jacksonville Jaguars,2014,3,13,0,0.188,249,412,-163,-10.2,-0.3,-10.5,-7.8,-2.7,11,5,0,430,305,125
Kansas City Chiefs,2014,9,7,0,0.563,353,281,72,4.5,1.2,5.7,0,5.7,8,8,0,317,335,-18
Miami Dolphins,2014,8,8,0,0.5,388,373,15,0.9,1.6,2.6,2.9,-0.4,5,10,1,391,480,-89
Minnesota Vikings,2014,7,9,0,0.438,325,343,-18,-1.1,-0.5,-1.7,-2.8,1.1,12,4,0,444,338,106
New England Patriots,2014,12,4,0,0.75,468,313,155,9.7,1.3,10.9,7.5,3.5,11,5,0,414,304,110
New Orleans Saints,2014,7,9,0,0.438,401,424,-23,-1.4,-1.5,-2.9,1.9,-4.8,7,9,0,294,383,-89
New York Giants,2014,6,10,0,0.375,380,400,-20,-1.3,-0.4,-1.7,0.8,-2.5,8,8,0,290,387,-97
New York Jets,2014,4,12,0,0.25,283,401,-118,-7.4,2.3,-5,-4,-1,4,12,0,322,453,-131
Philadelphia Eagles,2014,10,6,0,0.625,474,400,74,4.6,-0.7,3.9,6.6,-2.7,10,6,0,442,382,60
Pittsburgh Steelers,2014,11,5,0,0.688,436,368,68,4.3,-2,2.2,4.4,-2.1,8,8,0,379,370,9
San Diego Chargers,2014,9,7,0,0.563,348,348,0,0,1.9,1.9,0.7,1.2,9,7,0,396,348,48
San Francisco 49ers,2014,8,8,0,0.5,306,340,-34,-2.1,1.2,-1,-3,2.1,12,4,0,406,272,134
Seattle Seahawks,2014,12,4,0,0.75,394,254,140,8.8,0.8,9.5,2.4,7.1,13,3,0,417,231,186
St. Louis Rams,2014,6,10,0,0.375,324,354,-30,-1.9,1,-0.8,-1.2,0.4,7,9,0,348,364,-16
Tampa Bay Buccaneers,2014,2,14,0,0.125,277,410,-133,-8.3,-1.5,-9.8,-6.5,-3.3,4,12,0,288,389,-101
Tennessee Titans,2014,2,14,0,0.125,254,438,-184,-11.5,-0.3,-11.8,-7,-4.9,7,9,0,362,381,-19
Washington Redskins,2014,4,12,0,0.25,301,438,-137,-8.6,-0.2,-8.7,-4,-4.7,3,13,0,334,478,-144
Arizona Cardinals,2013,10,6,0,0.625,379,324,55,3.4,3,6.4,2.7,3.7,5,11,0,250,357,-107
Atlanta Falcons,2013,4,12,0,0.25,353,443,-90,-5.6,2.9,-2.8,1.2,-3.9,13,3,0,419,299,120
Baltimore Ravens,2013,8,8,0,0.5,320,352,-32,-2,-1.5,-3.5,-5,1.4,10,6,0,398,344,54
Buffalo Bills,2013,6,10,0,0.375,339,388,-49,-3.1,-0.1,-3.2,-1.3,-1.9,6,10,0,344,435,-91
Carolina Panthers,2013,12,4,0,0.75,366,241,125,7.8,1.4,9.2,0.6,8.6,7,9,0,357,363,-6
Chicago Bears,2013,8,8,0,0.5,445,478,-33,-2.1,-2.1,-4.1,3,-7.1,10,6,0,375,277,98
Cincinnati Bengals,2013,11,5,0,0.688,430,305,125,7.8,-2.5,5.4,2.3,3,10,6,0,391,320,71
Cleveland Browns,2013,4,12,0,0.25,308,406,-98,-6.1,-1.6,-7.7,-4.8,-2.9,5,11,0,302,368,-66
Dallas Cowboys,2013,8,8,0,0.5,439,432,7,0.4,-1.1,-0.7,2.7,-3.4,8,8,0,376,400,-24
Denver Broncos,2013,13,3,0,0.813,606,399,207,12.9,-1.6,11.4,14.1,-2.7,13,3,0,481,289,192
Detroit Lions,2013,7,9,0,0.438,395,376,19,1.2,-2.8,-1.6,-1.2,-0.5,4,12,0,372,437,-65
Green Bay Packers,2013,8,7,1,0.531,417,428,-11,-0.7,-2.4,-3.1,0.5,-3.6,11,5,0,433,336,97
Houston Texans,2013,2,14,0,0.125,276,428,-152,-9.5,1.9,-7.6,-5,-2.6,12,4,0,416,331,85
Indianapolis Colts,2013,11,5,0,0.688,391,336,55,3.4,0.6,4,1.7,2.3,11,5,0,357,387,-30
Jacksonville Jaguars,2013,4,12,0,0.25,247,449,-202,-12.6,1.5,-11.1,-7.1,-4,2,14,0,255,444,-189
Kansas City Chiefs,2013,11,5,0,0.688,430,305,125,7.8,-1.7,6.1,1.7,4.3,2,14,0,211,425,-214
Miami Dolphins,2013,8,8,0,0.5,317,335,-18,-1.1,0.3,-0.8,-2.9,2.1,7,9,0,288,317,-29
Minnesota Vikings,2013,5,10,1,0.344,391,480,-89,-5.6,-1.1,-6.6,0.2,-6.9,10,6,0,379,348,31
New England Patriots,2013,12,4,0,0.75,444,338,106,6.6,-0.7,5.9,4.5,1.4,12,4,0,557,331,226
New Orleans Saints,2013,11,5,0,0.688,414,304,110,6.9,1.9,8.8,3.8,5,7,9,0,461,454,7
New York Giants,2013,7,9,0,0.438,294,383,-89,-5.6,0.2,-5.4,-6.2,0.8,9,7,0,429,344,85
New York Jets,2013,8,8,0,0.5,290,387,-97,-6.1,0,-6.1,-4.7,-1.4,6,10,0,281,375,-94
Oakland Raiders,2013,4,12,0,0.25,322,453,-131,-8.2,0.2,-8,-3.8,-4.2,4,12,0,290,443,-153
Philadelphia Eagles,2013,10,6,0,0.625,442,382,60,3.8,-1.9,1.9,2.3,-0.5,4,12,0,280,444,-164
Pittsburgh Steelers,2013,8,8,0,0.5,379,370,9,0.6,-2.5,-2,-0.9,-1,8,8,0,336,314,22
San Diego Chargers,2013,9,7,0,0.563,396,348,48,3,-0.3,2.7,0.5,2.1,7,9,0,350,350,0
San Francisco 49ers,2013,12,4,0,0.75,406,272,134,8.4,1.8,10.1,3.5,6.6,11,4,1,397,273,124
Seattle Seahawks,2013,13,3,0,0.813,417,231,186,11.6,1.4,13,4.1,8.9,11,5,0,412,245,167
St. Louis Rams,2013,7,9,0,0.438,348,364,-16,-1,3.2,2.2,0.4,1.8,7,8,1,299,348,-49
Tampa Bay Buccaneers,2013,4,12,0,0.25,288,389,-101,-6.3,3.6,-2.7,-2.9,0.3,7,9,0,389,394,-5
Tennessee Titans,2013,7,9,0,0.438,362,381,-19,-1.2,0.4,-0.8,-0.2,-0.6,6,10,0,330,471,-141
Washington Redskins,2013,3,13,0,0.188,334,478,-144,-9,-0.3,-9.3,-3.9,-5.4,10,6,0,436,388,48
Arizona Cardinals,2012,5,11,0,0.313,250,357,-107,-6.7,3.5,-3.2,-4.8,1.6,8,8,0,312,348,-36
Atlanta Falcons,2012,13,3,0,0.813,419,299,120,7.5,-1.1,6.4,2,4.5,10,6,0,402,350,52
Baltimore Ravens,2012,10,6,0,0.625,398,344,54,3.4,-0.5,2.9,1.9,1,12,4,0,378,266,112
Buffalo Bills,2012,6,10,0,0.375,344,435,-91,-5.7,-1,-6.7,-0.9,-5.8,6,10,0,372,434,-62
Carolina Panthers,2012,7,9,0,0.438,357,363,-6,-0.4,1.2,0.8,-0.5,1.3,6,10,0,406,429,-23
Chicago Bears,2012,10,6,0,0.625,375,277,98,6.1,0.8,6.9,1,6,8,8,0,353,341,12
Cincinnati Bengals,2012,10,6,0,0.625,391,320,71,4.4,-2.4,2.1,1.2,0.9,9,7,0,344,323,21
Cleveland Browns,2012,5,11,0,0.313,302,368,-66,-4.1,-1.2,-5.3,-4.6,-0.7,4,12,0,218,307,-89
Dallas Cowboys,2012,8,8,0,0.5,376,400,-24,-1.5,1.8,0.3,1.4,-1.2,8,8,0,369,347,22
Denver Broncos,2012,13,3,0,0.813,481,289,192,12,-1.9,10.1,6.3,3.8,8,8,0,309,390,-81
Detroit Lions,2012,4,12,0,0.25,372,437,-65,-4.1,1.8,-2.3,2.1,-4.4,10,6,0,474,387,87
Green Bay Packers,2012,11,5,0,0.688,433,336,97,6.1,1.2,7.3,4.9,2.4,15,1,0,560,359,201
Houston Texans,2012,12,4,0,0.75,416,331,85,5.3,-1.8,3.5,1.8,1.7,10,6,0,381,278,103
Indianapolis Colts,2012,11,5,0,0.688,357,387,-30,-1.9,-2.8,-4.7,-1.9,-2.8,2,14,0,243,430,-187
Jacksonville Jaguars,2012,2,14,0,0.125,255,444,-189,-11.8,-1.1,-13,-8.1,-4.9,5,11,0,243,329,-86
Kansas City Chiefs,2012,2,14,0,0.125,211,425,-214,-13.4,-0.6,-14,-10.3,-3.7,7,9,0,212,338,-126
Miami Dolphins,2012,7,9,0,0.438,288,317,-29,-1.8,-0.8,-2.6,-5.5,2.9,6,10,0,329,313,16
Minnesota Vikings,2012,10,6,0,0.625,379,348,31,1.9,1.4,3.4,1.6,1.8,3,13,0,340,449,-109
New England Patriots,2012,12,4,0,0.75,557,331,226,14.1,-1.4,12.8,12.2,0.5,13,3,0,513,342,171
New Orleans Saints,2012,7,9,0,0.438,461,454,7,0.4,1,1.4,6.5,-5.1,13,3,0,547,339,208
New York Giants,2012,9,7,0,0.563,429,344,85,5.3,0.9,6.2,4,2.2,9,7,0,394,400,-6
New York Jets,2012,6,10,0,0.375,281,375,-94,-5.9,0,-5.9,-5.1,-0.9,8,8,0,377,363,14
Oakland Raiders,2012,4,12,0,0.25,290,443,-153,-9.6,-1.3,-10.8,-4.6,-6.2,8,8,0,359,433,-74
Philadelphia Eagles,2012,4,12,0,0.25,280,444,-164,-10.3,1.4,-8.9,-5.3,-3.6,8,8,0,396,328,68
Pittsburgh Steelers,2012,8,8,0,0.5,336,314,22,1.4,-2,-0.7,-2.8,2.1,12,4,0,325,227,98
San Diego Chargers,2012,7,9,0,0.438,350,350,0,0,-2.3,-2.3,-2,-0.4,8,8,0,406,377,29
San Francisco 49ers,2012,11,4,1,0.719,397,273,124,7.8,2.5,10.2,3.5,6.7,13,3,0,380,229,151
Seattle Seahawks,2012,11,5,0,0.688,412,245,167,10.4,1.8,12.2,4.5,7.7,7,9,0,321,315,6
St. Louis Rams,2012,7,8,1,0.469,299,348,-49,-3.1,3.4,0.4,-2.1,2.4,2,14,0,193,407,-214
Tampa Bay Buccaneers,2012,7,9,0,0.438,389,394,-5,-0.3,0.3,0,1.3,-1.3,4,12,0,287,494,-207
Tennessee Titans,2012,6,10,0,0.375,330,471,-141,-8.8,-1.2,-10,-2.6,-7.4,9,7,0,325,317,8
Washington Redskins*,2012,10,6,0,0.625,436,388,48,3,0.4,3.4,4.6,-1.2,5,11,0,288,367,-79
Arizona Cardinals,2011,8,8,0,0.5,312,348,-36,-2.3,0,-2.2,-1.7,-0.5,5,11,0,289,434,-145
Atlanta Falcons,2011,10,6,0,0.625,402,350,52,3.3,0.3,3.5,1.8,1.7,13,3,0,414,288,126
Baltimore Ravens,2011,12,4,0,0.75,378,266,112,7,-0.9,6.1,2.6,3.5,12,4,0,357,270,87
Buffalo Bills,2011,6,10,0,0.375,372,434,-62,-3.9,0.5,-3.4,1.2,-4.5,4,12,0,283,425,-142
Carolina Panthers,2011,6,10,0,0.375,406,429,-23,-1.4,0.1,-1.3,2.6,-3.9,2,14,0,196,408,-212
Chicago Bears,2011,8,8,0,0.5,353,341,12,0.8,0.9,1.7,-1.5,3.1,11,5,0,334,286,48
Cincinnati Bengals,2011,9,7,0,0.563,344,323,21,1.3,-0.9,0.5,0.7,-0.2,4,12,0,322,395,-73
Cleveland Browns,2011,4,12,0,0.25,218,307,-89,-5.6,0.2,-5.4,-7.2,1.8,5,11,0,271,332,-61
Dallas Cowboys,2011,8,8,0,0.5,369,347,22,1.4,0.3,1.6,0.7,0.9,6,10,0,394,436,-42
Denver Broncos,2011,8,8,0,0.5,309,390,-81,-5.1,-0.2,-5.3,-3.6,-1.7,4,12,0,344,471,-127
Detroit Lions,2011,10,6,0,0.625,474,387,87,5.4,0.6,6.1,6.9,-0.8,6,10,0,362,369,-7
Green Bay Packers,2011,15,1,0,0.938,560,359,201,12.6,-1.2,11.4,11.5,-0.1,10,6,0,388,240,148
Houston Texans,2011,10,6,0,0.625,381,278,103,6.4,-1.9,4.5,1.4,3.2,6,10,0,390,427,-37
Indianapolis Colts,2011,2,14,0,0.125,243,430,-187,-11.7,0.4,-11.3,-6,-5.3,10,6,0,435,388,47
Jacksonville Jaguars,2011,5,11,0,0.313,243,329,-86,-5.4,-0.3,-5.6,-7.1,1.4,8,8,0,353,419,-66
Kansas City Chiefs,2011,7,9,0,0.438,212,338,-126,-7.9,-0.2,-8.1,-10.2,2.1,10,6,0,366,326,40
Miami Dolphins,2011,6,10,0,0.375,329,313,16,1,-0.1,0.9,-2.2,3.2,7,9,0,273,333,-60
Minnesota Vikings,2011,3,13,0,0.188,340,449,-109,-6.8,1.1,-5.7,-1.6,-4.1,6,10,0,281,348,-67
New England Patriots,2011,13,3,0,0.813,513,342,171,10.7,-1.4,9.3,9.4,-0.1,14,2,0,518,313,205
New Orleans Saints,2011,13,3,0,0.813,547,339,208,13,-1.6,11.4,10.6,0.8,11,5,0,384,307,77
New York Giants,2011,9,7,0,0.563,394,400,-6,-0.4,2,1.6,3.1,-1.5,10,6,0,394,347,47
New York Jets,2011,8,8,0,0.5,377,363,14,0.9,0,0.9,1.2,-0.3,11,5,0,367,304,63
Oakland Raiders,2011,8,8,0,0.5,359,433,-74,-4.6,-0.3,-4.9,0.2,-5.1,8,8,0,410,371,39
Philadelphia Eagles,2011,8,8,0,0.5,396,328,68,4.3,0.5,4.7,3.1,1.7,10,6,0,439,377,62
Pittsburgh Steelers,2011,12,4,0,0.75,325,227,98,6.1,-0.8,5.3,-0.8,6,12,4,0,375,232,143
San Diego Chargers,2011,8,8,0,0.5,406,377,29,1.8,-0.9,0.9,2.7,-1.8,9,7,0,441,322,119
San Francisco 49ers,2011,13,3,0,0.813,380,229,151,9.4,-1.1,8.3,1.7,6.6,6,10,0,305,346,-41
Seattle Seahawks,2011,7,9,0,0.438,321,315,6,0.4,0.4,0.8,-0.5,1.3,7,9,0,310,407,-97
St. Louis Rams,2011,2,14,0,0.125,193,407,-214,-13.4,2.9,-10.4,-8.4,-2.1,7,9,0,289,328,-39
Tampa Bay Buccaneers,2011,4,12,0,0.25,287,494,-207,-12.9,2.3,-10.6,-4,-6.6,10,6,0,341,318,23
Tennessee Titans,2011,9,7,0,0.563,325,317,8,0.5,-1.5,-1,-2.2,1.2,6,10,0,356,339,17
Washington Redskins,2011,5,11,0,0.313,288,367,-79,-4.9,0.8,-4.1,-4.3,0.2,6,10,0,302,377,-75
Arizona Cardinals,2010,5,11,0,0.313,289,434,-145,-9.1,-3.6,-12.7,-5.6,-7.1,10,6,0,375,325,50
Atlanta Falcons,2010,13,3,0,0.813,414,288,126,7.9,-1.8,6.1,3.8,2.2,9,7,0,363,325,38
Baltimore Ravens,2010,12,4,0,0.75,357,270,87,5.4,1,6.4,0.9,5.5,9,7,0,391,261,130
Buffalo Bills,2010,4,12,0,0.25,283,425,-142,-8.9,4.3,-4.6,-1.5,-3.1,6,10,0,258,326,-68
Carolina Panthers,2010,2,14,0,0.125,196,408,-212,-13.3,0.1,-13.2,-9.1,-4.1,8,8,0,315,308,7
Chicago Bears,2010,11,5,0,0.688,334,286,48,3,1.1,4.1,-0.6,4.7,7,9,0,327,375,-48
Cincinnati Bengals,2010,4,12,0,0.25,322,395,-73,-4.6,3.1,-1.4,0.4,-1.9,10,6,0,305,291,14
Cleveland Browns,2010,5,11,0,0.313,271,332,-61,-3.8,2.3,-1.5,-3.4,2,5,11,0,245,375,-130
Dallas Cowboys,2010,6,10,0,0.375,394,436,-42,-2.6,0.5,-2.2,2.5,-4.7,11,5,0,361,250,111
Denver Broncos,2010,4,12,0,0.25,344,471,-127,-7.9,-1,-8.9,-1.1,-7.8,8,8,0,326,324,2
Detroit Lions,2010,6,10,0,0.375,362,369,-7,-0.4,2.3,1.9,2.4,-0.5,2,14,0,262,494,-232
Green Bay Packers,2010,10,6,0,0.625,388,240,148,9.3,1.7,10.9,3.1,7.9,11,5,0,461,297,164
Houston Texans,2010,6,10,0,0.375,390,427,-37,-2.3,0.5,-1.8,1.8,-3.7,9,7,0,388,333,55
Indianapolis Colts,2010,10,6,0,0.625,435,388,47,2.9,-0.1,2.9,3.7,-0.9,14,2,0,416,307,109
Jacksonville Jaguars,2010,8,8,0,0.5,353,419,-66,-4.1,-0.4,-4.5,-1.2,-3.3,7,9,0,290,380,-90
Kansas City Chiefs,2010,10,6,0,0.625,366,326,40,2.5,-3.2,-0.7,-1.5,0.8,4,12,0,294,424,-130
Miami Dolphins,2010,7,9,0,0.438,273,333,-60,-3.8,4.1,0.3,-2.8,3.1,7,9,0,360,390,-30
Minnesota Vikings,2010,6,10,0,0.375,281,348,-67,-4.2,2.6,-1.6,-3.3,1.7,12,4,0,470,312,158
New England Patriots,2010,14,2,0,0.875,518,313,205,12.8,2.6,15.4,12.6,2.8,10,6,0,427,285,142
New Orleans Saints,2010,11,5,0,0.688,384,307,77,4.8,-2.5,2.3,1.5,0.8,13,3,0,510,341,169
New York Giants,2010,10,6,0,0.625,394,347,47,2.9,-0.8,2.1,1.7,0.4,8,8,0,402,427,-25
New York Jets,2010,11,5,0,0.688,367,304,63,3.9,2.5,6.5,2.2,4.2,9,7,0,348,236,112
Oakland Raiders,2010,8,8,0,0.5,410,371,39,2.4,-2.3,0.2,2.3,-2.2,5,11,0,197,379,-182
Philadelphia Eagles,2010,10,6,0,0.625,439,377,62,3.9,0.3,4.2,5.4,-1.2,11,5,0,429,337,92
Pittsburgh Steelers,2010,12,4,0,0.75,375,232,143,8.9,1.3,10.2,2.5,7.7,9,7,0,368,324,44
San Diego Chargers,2010,9,7,0,0.563,441,322,119,7.4,-2.6,4.8,3.2,1.6,13,3,0,454,320,134
San Francisco 49ers,2010,6,10,0,0.375,305,346,-41,-2.6,-3.3,-5.8,-4.7,-1.1,8,8,0,330,281,49
Seattle Seahawks,2010,7,9,0,0.438,310,407,-97,-6.1,-3.4,-9.4,-3.9,-5.5,5,11,0,280,390,-110
St. Louis Rams,2010,7,9,0,0.438,289,328,-39,-2.4,-4.2,-6.7,-6.3,-0.4,1,15,0,175,436,-261
Tampa Bay Buccaneers,2010,10,6,0,0.625,341,318,23,1.4,-2,-0.6,-1,0.4,3,13,0,244,400,-156
Tennessee Titans,2010,6,10,0,0.375,356,339,17,1.1,0,1,-0.9,1.9,8,8,0,354,402,-48
Washington Redskins,2010,6,10,0,0.375,302,377,-75,-4.7,0.9,-3.8,-3.4,-0.5,4,12,0,266,336,-70
Arizona Cardinals,2009,10,6,0,0.625,375,325,50,3.1,-3.4,-0.3,0.1,-0.4,9,7,0,427,426,1
Atlanta Falcons,2009,9,7,0,0.563,363,325,38,2.4,2.7,5,2.7,2.3,11,5,0,391,325,66
Baltimore Ravens,2009,9,7,0,0.563,391,261,130,8.1,-0.7,7.5,2.6,4.9,11,5,0,385,244,141
Buffalo Bills,2009,6,10,0,0.375,258,326,-68,-4.3,2.4,-1.8,-4.5,2.7,7,9,0,336,342,-6
Carolina Panthers,2009,8,8,0,0.5,315,308,7,0.4,3.5,3.9,-0.6,4.5,12,4,0,414,329,85
Chicago Bears,2009,7,9,0,0.438,327,375,-48,-3,-0.9,-3.9,-1.9,-2,9,7,0,375,350,25
Cincinnati Bengals,2009,10,6,0,0.625,305,291,14,0.9,-0.2,0.7,-2.5,3.2,4,11,1,204,364,-160
Cleveland Browns,2009,5,11,0,0.313,245,375,-130,-8.1,-0.3,-8.4,-6,-2.4,4,12,0,232,350,-118
Dallas Cowboys,2009,11,5,0,0.688,361,250,111,6.9,0.2,7.1,0.4,6.7,9,7,0,362,365,-3
Denver Broncos,2009,8,8,0,0.5,326,324,2,0.1,0.2,0.3,-1,1.3,8,8,0,370,448,-78
Detroit Lions,2009,2,14,0,0.125,262,494,-232,-14.5,0.1,-14.4,-5.2,-9.2,0,16,0,268,517,-249
Green Bay Packers,2009,11,5,0,0.688,461,297,164,10.3,-2.9,7.4,6.3,1.1,6,10,0,419,380,39
Houston Texans,2009,9,7,0,0.563,388,333,55,3.4,-1.5,2,2.7,-0.7,8,8,0,366,394,-28
Indianapolis Colts,2009,14,2,0,0.875,416,307,109,6.8,-0.9,5.9,4.4,1.5,12,4,0,377,298,79
Jacksonville Jaguars,2009,7,9,0,0.438,290,380,-90,-5.6,-0.9,-6.5,-3.8,-2.6,5,11,0,302,367,-65
Kansas City Chiefs,2009,4,12,0,0.25,294,424,-130,-8.1,-0.3,-8.4,-2.5,-5.9,2,14,0,291,440,-149
Miami Dolphins,2009,7,9,0,0.438,360,390,-30,-1.9,3.6,1.7,2.9,-1.2,11,5,0,345,317,28
Minnesota Vikings,2009,12,4,0,0.75,470,312,158,9.9,-2.7,7.2,6.6,0.6,10,6,0,379,333,46
New England Patriots,2009,10,6,0,0.625,427,285,142,8.9,2.3,11.2,6.7,4.5,11,5,0,410,309,101
New Orleans Saints,2009,13,3,0,0.813,510,341,169,10.6,0.2,10.8,11.2,-0.5,8,8,0,463,393,70
New York Giants,2009,8,8,0,0.5,402,427,-25,-1.6,1.6,0.1,4.6,-4.5,12,4,0,427,294,133
New York Jets,2009,9,7,0,0.563,348,236,112,7,1.6,8.6,1.1,7.5,9,7,0,405,356,49
Oakland Raiders,2009,5,11,0,0.313,197,379,-182,-11.4,1.1,-10.3,-8.7,-1.6,5,11,0,263,388,-125
Philadelphia Eagles,2009,11,5,0,0.688,429,337,92,5.8,0.2,6,5.8,0.2,9,6,1,416,289,127
Pittsburgh Steelers,2009,9,7,0,0.563,368,324,44,2.8,-1.1,1.7,1,0.7,12,4,0,347,223,124
San Diego Chargers,2009,13,3,0,0.813,454,320,134,8.4,-1.7,6.6,6.4,0.2,8,8,0,439,347,92
San Francisco 49ers,2009,8,8,0,0.5,330,281,49,3.1,-3,0.1,-2.9,3,7,9,0,339,381,-42
Seattle Seahawks,2009,5,11,0,0.313,280,390,-110,-6.9,-2.4,-9.3,-5,-4.4,4,12,0,294,392,-98
St. Louis Rams,2009,1,15,0,0.063,175,436,-261,-16.3,-1.1,-17.4,-11.7,-5.8,2,14,0,232,465,-233
Tampa Bay Buccaneers,2009,3,13,0,0.188,244,400,-156,-9.8,4.1,-5.6,-4.6,-1.1,9,7,0,361,323,38
Tennessee Titans,2009,8,8,0,0.5,354,402,-48,-3,0.2,-2.8,0.9,-3.6,13,3,0,375,234,141
Washington Redskins,2009,4,12,0,0.25,266,336,-70,-4.4,-0.2,-4.6,-5.5,1,8,8,0,265,296,-31
Arizona Cardinals,2008,9,7,0,0.563,427,426,1,0.1,-1.9,-1.9,4.1,-6,8,8,0,404,399,5
Atlanta Falcons,2008,11,5,0,0.688,391,325,66,4.1,-0.3,3.8,1.3,2.5,4,12,0,259,414,-155
Baltimore Ravens,2008,11,5,0,0.688,385,244,141,8.8,1,9.8,4.2,5.6,5,11,0,275,384,-109
Buffalo Bills,2008,7,9,0,0.438,336,342,-6,-0.4,-3,-3.3,-2.8,-0.6,7,9,0,252,354,-102
Carolina Panthers,2008,12,4,0,0.75,414,329,85,5.3,0.3,5.6,2.8,2.9,7,9,0,267,347,-80
Chicago Bears,2008,9,7,0,0.563,375,350,25,1.6,0.5,2.1,1.1,1,7,9,0,334,348,-14
Cincinnati Bengals,2008,4,11,1,0.281,204,364,-160,-10,3,-7,-6.9,-0.1,7,9,0,380,385,-5
Cleveland Browns,2008,4,12,0,0.25,232,350,-118,-7.4,2.7,-4.6,-5.2,0.6,10,6,0,402,382,20
Dallas Cowboys,2008,9,7,0,0.563,362,365,-3,-0.2,0.8,0.6,1.7,-1.2,13,3,0,455,325,130
Denver Broncos,2008,8,8,0,0.5,370,448,-78,-4.9,-0.9,-5.8,0.7,-6.5,7,9,0,320,409,-89
Detroit Lions,2008,0,16,0,0,268,517,-249,-15.6,2.5,-13.1,-4,-9.1,7,9,0,346,444,-98
Green Bay Packers,2008,6,10,0,0.375,419,380,39,2.4,0.5,2.9,4.1,-1.2,13,3,0,435,291,144
Houston Texans,2008,8,8,0,0.5,366,394,-28,-1.8,1.4,-0.4,2.8,-3.2,8,8,0,379,384,-5
Indianapolis Colts,2008,12,4,0,0.75,377,298,79,4.9,1.6,6.5,2.6,3.9,13,3,0,450,262,188
Jacksonville Jaguars,2008,5,11,0,0.313,302,367,-65,-4.1,1.6,-2.5,-2.1,-0.4,11,5,0,411,304,107
Kansas City Chiefs,2008,2,14,0,0.125,291,440,-149,-9.3,0.1,-9.2,-3.9,-5.3,4,12,0,226,335,-109
Miami Dolphins,2008,11,5,0,0.688,345,317,28,1.8,-2.3,-0.5,-2.4,1.8,1,15,0,267,437,-170
Minnesota Vikings,2008,10,6,0,0.625,379,333,46,2.9,1.2,4,1.1,2.9,8,8,0,365,311,54
New England Patriots,2008,11,5,0,0.688,410,309,101,6.3,-2.4,3.9,2.3,1.6,16,0,0,589,274,315
New Orleans Saints,2008,8,8,0,0.5,463,393,70,4.4,-0.3,4,6.8,-2.8,7,9,0,379,388,-9
New York Giants,2008,12,4,0,0.75,427,294,133,8.3,0.1,8.4,5.5,2.8,10,6,0,373,351,22
New York Jets,2008,9,7,0,0.563,405,356,49,3.1,-2.8,0.2,2.2,-1.9,4,12,0,268,355,-87
Oakland Raiders,2008,5,11,0,0.313,263,388,-125,-7.8,0.3,-7.5,-6.5,-1,4,12,0,283,398,-115
Philadelphia Eagles,2008,9,6,1,0.594,416,289,127,7.9,-0.1,7.8,4.7,3.2,8,8,0,336,300,36
Pittsburgh Steelers,2008,12,4,0,0.75,347,223,124,7.8,2,9.8,1.6,8.2,10,6,0,393,269,124
San Diego Chargers,2008,8,8,0,0.5,439,347,92,5.8,-0.8,5,5,0,11,5,0,412,284,128
San Francisco 49ers,2008,7,9,0,0.438,339,381,-42,-2.6,-2.7,-5.3,-2.9,-2.4,5,11,0,219,364,-145
Seattle Seahawks,2008,4,12,0,0.25,294,392,-98,-6.1,-1.5,-7.6,-4.9,-2.8,10,6,0,393,291,102
St. Louis Rams,2008,2,14,0,0.125,232,465,-233,-14.6,-0.5,-15.1,-8.1,-7,3,13,0,263,438,-175
Tampa Bay Buccaneers,2008,9,7,0,0.563,361,323,38,2.4,-0.1,2.3,-0.6,2.9,9,7,0,334,270,64
Tennessee Titans,2008,13,3,0,0.813,375,234,141,8.8,0.1,8.9,1.5,7.5,10,6,0,301,297,4
Washington Redskins,2008,8,8,0,0.5,265,296,-31,-1.9,0.2,-1.8,-5.8,4.1,9,7,0,334,310,24
Arizona Cardinals,2007,8,8,0,0.5,404,399,5,0.3,-4.3,-3.9,1.9,-5.9,5,11,0,314,389,-75
Atlanta Falcons,2007,4,12,0,0.25,259,414,-155,-9.7,-0.9,-10.6,-5.8,-4.8,7,9,0,292,328,-36
Baltimore Ravens,2007,5,11,0,0.313,275,384,-109,-6.8,0.1,-6.7,-5,-1.8,13,3,0,353,201,152
Buffalo Bills,2007,7,9,0,0.438,252,354,-102,-6.4,2.3,-4.1,-5.6,1.5,7,9,0,300,311,-11
Carolina Panthers,2007,7,9,0,0.438,267,347,-80,-5,-0.8,-5.8,-5.7,-0.1,8,8,0,270,305,-35
Chicago Bears,2007,7,9,0,0.438,334,348,-14,-0.9,2.1,1.2,-0.2,1.4,13,3,0,427,255,172
Cincinnati Bengals,2007,7,9,0,0.438,380,385,-5,-0.3,-2.1,-2.4,1.6,-4,8,8,0,373,331,42
Cleveland Browns,2007,10,6,0,0.625,402,382,20,1.3,-2.3,-1.1,2.2,-3.3,4,12,0,238,356,-118
Dallas Cowboys,2007,13,3,0,0.813,455,325,130,8.1,1.3,9.5,7.8,1.7,9,7,0,425,350,75
Denver Broncos,2007,7,9,0,0.438,320,409,-89,-5.6,1.6,-3.9,-0.2,-3.8,9,7,0,319,305,14
Detroit Lions,2007,7,9,0,0.438,346,444,-98,-6.1,2.6,-3.6,1.4,-5,3,13,0,305,398,-93
Green Bay Packers,2007,13,3,0,0.813,435,291,144,9,0,9,5.7,3.3,8,8,0,301,366,-65
Houston Texans,2007,8,8,0,0.5,379,384,-5,-0.3,0.3,0,2.5,-2.5,6,10,0,267,366,-99
Indianapolis Colts,2007,13,3,0,0.813,450,262,188,11.8,0.3,12,6.6,5.4,12,4,0,427,360,67
Jacksonville Jaguars,2007,11,5,0,0.688,411,304,107,6.7,0.1,6.8,4.8,2,8,8,0,371,274,97
Kansas City Chiefs,2007,4,12,0,0.25,226,335,-109,-6.8,1.4,-5.5,-7.4,1.9,9,7,0,331,315,16
Miami Dolphins,2007,1,15,0,0.063,267,437,-170,-10.6,2.3,-8.4,-4.1,-4.2,6,10,0,260,283,-23
Minnesota Vikings,2007,8,8,0,0.5,365,311,54,3.4,0.4,3.8,1.4,2.4,6,10,0,282,327,-45
New England Patriots,2007,16,0,0,1,589,274,315,19.7,0.4,20.1,15.9,4.2,12,4,0,385,237,148
New Orleans Saints,2007,7,9,0,0.438,379,388,-9,-0.6,-2,-2.5,1.9,-4.5,10,6,0,413,322,91
New York Giants,2007,10,6,0,0.625,373,351,22,1.4,1.9,3.3,2.8,0.4,8,8,0,355,362,-7
New York Jets,2007,4,12,0,0.25,268,355,-87,-5.4,1.7,-3.7,-4,0.3,10,6,0,316,295,21
Oakland Raiders,2007,4,12,0,0.25,283,398,-115,-7.2,1.2,-6,-3.5,-2.5,2,14,0,168,332,-164
Philadelphia Eagles,2007,8,8,0,0.5,336,300,36,2.3,3,5.3,0.1,5.1,10,6,0,398,328,70
Pittsburgh Steelers,2007,10,6,0,0.625,393,269,124,7.8,-2.5,5.2,0.9,4.3,8,8,0,353,315,38
San Diego Chargers,2007,11,5,0,0.688,412,284,128,8,0.8,8.8,4.3,4.5,14,2,0,492,303,189
San Francisco 49ers,2007,5,11,0,0.313,219,364,-145,-9.1,-2.9,-11.9,-9.9,-2,7,9,0,298,412,-114
Seattle Seahawks,2007,10,6,0,0.625,393,291,102,6.4,-4.6,1.8,0.8,0.9,9,7,0,335,341,-6
St. Louis Rams,2007,3,13,0,0.188,263,438,-175,-10.9,-2,-13,-6.5,-6.5,8,8,0,367,381,-14
Tampa Bay Buccaneers,2007,9,7,0,0.563,334,270,64,4,-2.8,1.2,-2.3,3.6,4,12,0,211,353,-142
Tennessee Titans,2007,10,6,0,0.625,301,297,4,0.3,0.5,0.7,-2.9,3.6,8,8,0,324,400,-76
Washington Redskins,2007,9,7,0,0.563,334,310,24,1.5,3,4.5,0.2,4.3,5,11,0,307,376,-69
Arizona Cardinals,2006,5,11,0,0.313,314,389,-75,-4.7,-2.2,-6.9,-2.6,-4.3,5,11,0,311,387,-76
Atlanta Falcons,2006,7,9,0,0.438,292,328,-36,-2.3,-0.8,-3,-2.8,-0.2,8,8,0,351,341,10
Baltimore Ravens,2006,13,3,0,0.813,353,201,152,9.5,-0.2,9.3,1.5,7.8,6,10,0,265,299,-34
Buffalo Bills,2006,7,9,0,0.438,300,311,-11,-0.7,2.9,2.2,-0.2,2.4,5,11,0,271,367,-96
Carolina Panthers,2006,8,8,0,0.5,270,305,-35,-2.2,-0.5,-2.7,-4.2,1.5,11,5,0,391,259,132
Chicago Bears,2006,13,3,0,0.813,427,255,172,10.8,-2.9,7.9,4.9,3,11,5,0,260,202,58
Cincinnati Bengals,2006,8,8,0,0.5,373,331,42,2.6,1.5,4.1,4,0,11,5,0,421,350,71
Cleveland Browns,2006,4,12,0,0.25,238,356,-118,-7.4,1.5,-5.8,-4.5,-1.3,6,10,0,232,301,-69
Dallas Cowboys,2006,9,7,0,0.563,425,350,75,4.7,-1,3.7,5,-1.3,9,7,0,325,308,17
Denver Broncos,2006,9,7,0,0.563,319,305,14,0.9,0.4,1.3,-0.8,2.1,13,3,0,395,258,137
Detroit Lions,2006,3,13,0,0.188,305,398,-93,-5.8,-0.5,-6.4,-1.8,-4.6,5,11,0,254,345,-91
Green Bay Packers,2006,8,8,0,0.5,301,366,-65,-4.1,-0.4,-4.4,-2.3,-2.1,4,12,0,298,344,-46
Houston Texans,2006,6,10,0,0.375,267,366,-99,-6.2,1.7,-4.5,-3.2,-1.3,2,14,0,260,431,-171
Indianapolis Colts,2006,12,4,0,0.75,427,360,67,4.2,1.7,5.9,6.9,-1.1,14,2,0,439,247,192
Jacksonville Jaguars,2006,8,8,0,0.5,371,274,97,6.1,1.4,7.5,2.6,4.9,12,4,0,361,269,92
Kansas City Chiefs,2006,9,7,0,0.563,331,315,16,1,0,1,0.4,0.6,10,6,0,403,325,78
Miami Dolphins,2006,6,10,0,0.375,260,283,-23,-1.4,2.1,0.7,-3.3,4,9,7,0,318,317,1
Minnesota Vikings,2006,6,10,0,0.375,282,327,-45,-2.8,-1.3,-4.1,-3.7,-0.4,9,7,0,306,344,-38
New England Patriots,2006,12,4,0,0.75,385,237,148,9.3,1,10.2,4.3,5.9,10,6,0,379,338,41
New Orleans Saints,2006,10,6,0,0.625,413,322,91,5.7,-1.6,4,4.9,-0.9,3,13,0,235,398,-163
New York Giants,2006,8,8,0,0.5,355,362,-7,-0.4,0.5,0.1,1.2,-1.1,11,5,0,422,314,108
New York Jets,2006,10,6,0,0.625,316,295,21,1.3,0.7,2,0.4,1.7,4,12,0,240,355,-115
Oakland Raiders,2006,2,14,0,0.125,168,332,-164,-10.3,0.6,-9.6,-10.3,0.7,4,12,0,290,383,-93
Philadelphia Eagles,2006,10,6,0,0.625,398,328,70,4.4,-1,3.4,3.2,0.2,6,10,0,310,388,-78
Pittsburgh Steelers,2006,8,8,0,0.5,353,315,38,2.4,1,3.4,3,0.4,11,5,0,389,258,131
San Diego Chargers,2006,14,2,0,0.875,492,303,189,11.8,-1.6,10.2,10,0.2,9,7,0,418,312,106
San Francisco 49ers,2006,7,9,0,0.438,298,412,-114,-7.1,-1.6,-8.7,-3.5,-5.2,4,12,0,239,428,-189
Seattle Seahawks,2006,9,7,0,0.563,335,341,-6,-0.4,-3.2,-3.6,-1.7,-1.9,13,3,0,452,271,181
St. Louis Rams,2006,8,8,0,0.5,367,381,-14,-0.9,-3.1,-4,0.8,-4.7,6,10,0,363,429,-66
Tampa Bay Buccaneers,2006,4,12,0,0.25,211,353,-142,-8.9,0.9,-7.9,-7.2,-0.8,11,5,0,300,274,26
Tennessee Titans,2006,8,8,0,0.5,324,400,-76,-4.8,3.5,-1.3,1,-2.3,4,12,0,299,421,-122
Washington Redskins,2006,5,11,0,0.313,307,376,-69,-4.3,0.3,-4,-2.1,-2,10,6,0,359,293,66
Arizona Cardinals,2005,5,11,0,0.313,311,387,-76,-4.8,-0.2,-5,-2,-3,6,10,0,284,322,-38
Atlanta Falcons,2005,8,8,0,0.5,351,341,10,0.6,-1.9,-1.2,1.1,-2.3,11,5,0,340,337,3
Baltimore Ravens,2005,6,10,0,0.375,265,299,-34,-2.1,0.3,-1.8,-3.5,1.7,9,7,0,317,268,49
Buffalo Bills,2005,5,11,0,0.313,271,367,-96,-6,0.2,-5.8,-4,-1.8,9,7,0,395,284,111
Carolina Panthers,2005,11,5,0,0.688,391,259,132,8.3,-3.2,5.1,3,2.1,7,9,0,355,339,16
Chicago Bears,2005,11,5,0,0.688,260,202,58,3.6,-2.2,1.4,-5.2,6.6,5,11,0,231,331,-100
Cincinnati Bengals,2005,11,5,0,0.688,421,350,71,4.4,-0.6,3.8,6.5,-2.7,8,8,0,374,372,2
Cleveland Browns,2005,6,10,0,0.375,232,301,-69,-4.3,0.1,-4.2,-6,1.7,4,12,0,276,390,-114
Dallas Cowboys,2005,9,7,0,0.563,325,308,17,1.1,2.1,3.2,-0.1,3.2,6,10,0,293,405,-112
Denver Broncos,2005,13,3,0,0.813,395,258,137,8.6,2.2,10.8,5,5.8,10,6,0,381,304,77
Detroit Lions,2005,5,11,0,0.313,254,345,-91,-5.7,-1,-6.7,-4.3,-2.4,6,10,0,296,350,-54
Green Bay Packers,2005,4,12,0,0.25,298,344,-46,-2.9,-0.8,-3.7,-1.5,-2.2,10,6,0,424,380,44
Houston Texans,2005,2,14,0,0.125,260,431,-171,-10.7,0.7,-10,-4.4,-5.7,7,9,0,309,339,-30
Indianapolis Colts,2005,14,2,0,0.875,439,247,192,12,-1.2,10.8,5.6,5.2,12,4,0,522,351,171
Jacksonville Jaguars,2005,12,4,0,0.75,361,269,92,5.8,-1,4.8,1.1,3.7,9,7,0,261,280,-19
Kansas City Chiefs,2005,10,6,0,0.625,403,325,78,4.9,2.1,7,5.1,1.9,7,9,0,483,435,48
Miami Dolphins,2005,9,7,0,0.563,318,317,1,0.1,-0.8,-0.8,-1.1,0.3,4,12,0,275,354,-79
Minnesota Vikings,2005,9,7,0,0.563,306,344,-38,-2.4,-1.1,-3.5,-1.4,-2.1,8,8,0,405,395,10
New England Patriots,2005,10,6,0,0.625,379,338,41,2.6,0.6,3.1,3.7,-0.5,14,2,0,437,260,177
New Orleans Saints,2005,3,13,0,0.188,235,398,-163,-10.2,-0.9,-11.1,-6.2,-4.9,8,8,0,348,405,-57
New York Giants,2005,11,5,0,0.688,422,314,108,6.8,0.7,7.5,5.8,1.7,6,10,0,303,347,-44
New York Jets,2005,4,12,0,0.25,240,355,-115,-7.2,0.8,-6.4,-5.2,-1.2,10,6,0,333,261,72
Oakland Raiders,2005,4,12,0,0.25,290,383,-93,-5.8,3,-2.8,-1.2,-1.6,5,11,0,320,442,-122
Philadelphia Eagles,2005,6,10,0,0.375,310,388,-78,-4.9,2.6,-2.3,-0.7,-1.7,13,3,0,386,260,126
Pittsburgh Steelers,2005,11,5,0,0.688,389,258,131,8.2,-0.4,7.8,3.8,4,15,1,0,372,251,121
San Diego Chargers,2005,9,7,0,0.563,418,312,106,6.6,3.3,9.9,7.1,2.9,12,4,0,446,313,133
San Francisco 49ers,2005,4,12,0,0.25,239,428,-189,-11.8,0.7,-11.1,-5.6,-5.5,2,14,0,259,452,-193
Seattle Seahawks,2005,13,3,0,0.813,452,271,181,11.3,-2.2,9.1,5.8,3.4,9,7,0,371,373,-2
St. Louis Rams,2005,6,10,0,0.375,363,429,-66,-4.1,-1,-5.1,1.3,-6.4,8,8,0,319,392,-73
Tampa Bay Buccaneers,2005,11,5,0,0.688,300,274,26,1.6,-2.6,-1,-2.8,1.8,5,11,0,301,304,-3
Tennessee Titans,2005,4,12,0,0.25,299,421,-122,-7.6,0.1,-7.6,-2,-5.5,5,11,0,344,439,-95
Washington Redskins,2005,10,6,0,0.625,359,293,66,4.1,1.9,6,2.6,3.4,6,10,0,240,265,-25
Arizona Cardinals,2004,6,10,0,0.375,284,322,-38,-2.4,-2.5,-4.9,-5.1,0.2,4,12,0,225,452,-227
Atlanta Falcons,2004,11,5,0,0.688,340,337,3,0.2,-2.4,-2.2,-1.8,-0.4,5,11,0,299,422,-123
Baltimore Ravens,2004,9,7,0,0.563,317,268,49,3.1,3.1,6.1,-0.6,6.8,10,6,0,391,281,110
Buffalo Bills,2004,9,7,0,0.563,395,284,111,6.9,1.1,8.1,4.6,3.5,6,10,0,243,279,-36
Carolina Panthers,2004,7,9,0,0.438,355,339,16,1,-1.7,-0.7,-0.8,0.1,11,5,0,325,304,21
Chicago Bears,2004,5,11,0,0.313,231,331,-100,-6.3,-2,-8.2,-8.5,0.3,7,9,0,283,346,-63
Cincinnati Bengals,2004,8,8,0,0.5,374,372,2,0.1,2.5,2.7,4.3,-1.6,8,8,0,346,384,-38
Cleveland Browns,2004,4,12,0,0.25,276,390,-114,-7.1,3.7,-3.4,-1.5,-1.9,5,11,0,254,322,-68
Dallas Cowboys,2004,6,10,0,0.375,293,405,-112,-7,-0.8,-7.8,-3,-4.8,10,6,0,289,260,29
Denver Broncos,2004,10,6,0,0.625,381,304,77,4.8,1,5.9,1.6,4.3,10,6,0,381,301,80
Detroit Lions,2004,6,10,0,0.375,296,350,-54,-3.4,-1.8,-5.2,-3.8,-1.4,5,11,0,270,379,-109
Green Bay Packers,2004,10,6,0,0.625,424,380,44,2.8,-2.4,0.3,4.3,-4,10,6,0,442,307,135
Houston Texans,2004,7,9,0,0.438,309,339,-30,-1.9,1.2,-0.6,-2.4,1.8,5,11,0,255,380,-125
Indianapolis Colts,2004,12,4,0,0.75,522,351,171,10.7,0.7,11.4,11.7,-0.3,12,4,0,447,336,111
Jacksonville Jaguars,2004,9,7,0,0.563,261,280,-19,-1.2,1.9,0.8,-5.7,6.4,5,11,0,276,331,-55
Kansas City Chiefs,2004,7,9,0,0.438,483,435,48,3,2.3,5.3,10,-4.7,13,3,0,484,332,152
Miami Dolphins,2004,4,12,0,0.25,275,354,-79,-4.9,2.7,-2.2,-2.7,0.5,10,6,0,311,261,50
Minnesota Vikings,2004,8,8,0,0.5,405,395,10,0.6,-2.3,-1.7,3,-4.7,9,7,0,416,353,63
New England Patriots,2004,14,2,0,0.875,437,260,177,11.1,1.8,12.8,6.4,6.5,14,2,0,348,238,110
New Orleans Saints,2004,8,8,0,0.5,348,405,-57,-3.6,-2,-5.6,-1.2,-4.3,8,8,0,340,326,14
New York Giants,2004,6,10,0,0.375,303,347,-44,-2.8,-1.2,-3.9,-2.3,-1.6,4,12,0,243,387,-144
New York Jets,2004,10,6,0,0.625,333,261,72,4.5,2.1,6.6,0.5,6,6,10,0,283,299,-16
Oakland Raiders,2004,5,11,0,0.313,320,442,-122,-7.6,3.4,-4.3,-0.6,-3.7,4,12,0,270,379,-109
Philadelphia Eagles,2004,13,3,0,0.813,386,260,126,7.9,-2.3,5.6,2,3.5,12,4,0,374,287,87
Pittsburgh Steelers,2004,15,1,0,0.938,372,251,121,7.6,1.4,9,3.4,5.6,6,10,0,300,327,-27
San Diego Chargers,2004,12,4,0,0.75,446,313,133,8.3,0.8,9.1,6.1,3,4,12,0,313,441,-128
San Francisco 49ers,2004,2,14,0,0.125,259,452,-193,-12.1,-1.6,-13.6,-5.1,-8.6,7,9,0,384,337,47
Seattle Seahawks,2004,9,7,0,0.563,371,373,-2,-0.1,-2.8,-2.9,0.4,-3.3,10,6,0,404,327,77
St. Louis Rams,2004,8,8,0,0.5,319,392,-73,-4.6,-1.4,-6,-2.2,-3.8,12,4,0,447,328,119
Tampa Bay Buccaneers,2004,5,11,0,0.313,301,304,-3,-0.2,-2.5,-2.7,-4,1.3,7,9,0,301,264,37
Tennessee Titans,2004,5,11,0,0.313,344,439,-95,-5.9,1.5,-4.4,0.3,-4.6,12,4,0,435,324,111
Washington Redskins,2004,6,10,0,0.375,240,265,-25,-1.6,-1.8,-3.4,-7.4,4,5,11,0,287,372,-85
Arizona Cardinals,2003,4,12,0,0.25,225,452,-227,-14.2,1.6,-12.6,-6.3,-6.2,5,11,0,262,417,-155
Atlanta Falcons,2003,5,11,0,0.313,299,422,-123,-7.7,0.3,-7.4,-2,-5.4,9,6,1,402,314,88
Baltimore Ravens,2003,10,6,0,0.625,391,281,110,6.9,-0.6,6.3,3.3,3,7,9,0,316,354,-38
Buffalo Bills,2003,6,10,0,0.375,243,279,-36,-2.3,1.3,-1,-5,4,8,8,0,379,397,-18
Carolina Panthers,2003,11,5,0,0.688,325,304,21,1.3,-2.2,-0.9,-1.5,0.6,7,9,0,258,302,-44
Chicago Bears,2003,7,9,0,0.438,283,346,-63,-3.9,0.4,-3.5,-4.2,0.7,4,12,0,281,379,-98
Cincinnati Bengals,2003,8,8,0,0.5,346,384,-38,-2.4,0,-2.4,1.1,-3.5,2,14,0,279,456,-177
Cleveland Browns,2003,5,11,0,0.313,254,322,-68,-4.3,1.3,-2.9,-5.3,2.4,9,7,0,344,320,24
Dallas Cowboys,2003,10,6,0,0.625,289,260,29,1.8,-2.3,-0.5,-3.2,2.7,5,11,0,217,329,-112
Denver Broncos,2003,10,6,0,0.625,381,301,80,5,0.5,5.5,2.4,3.1,9,7,0,392,344,48
Detroit Lions,2003,5,11,0,0.313,270,379,-109,-6.8,1,-5.8,-4.3,-1.6,3,13,0,306,451,-145
Green Bay Packers,2003,10,6,0,0.625,442,307,135,8.4,-0.3,8.1,6.2,1.9,12,4,0,398,328,70
Houston Texans,2003,5,11,0,0.313,255,380,-125,-7.8,1.9,-6,-4.4,-1.5,4,12,0,213,356,-143
Indianapolis Colts,2003,12,4,0,0.75,447,336,111,6.9,0,7,8.2,-1.2,10,6,0,349,313,36
Jacksonville Jaguars,2003,5,11,0,0.313,276,331,-55,-3.4,1,-2.4,-3.3,0.9,6,10,0,328,315,13
Kansas City Chiefs,2003,13,3,0,0.813,484,332,152,9.5,-1.2,8.3,9.2,-0.9,8,8,0,467,399,68
Miami Dolphins,2003,10,6,0,0.625,311,261,50,3.1,0.3,3.4,-0.7,4.1,9,7,0,378,301,77
Minnesota Vikings,2003,9,7,0,0.563,416,353,63,3.9,-1,2.9,4,-1.1,6,10,0,390,442,-52
New England Patriots,2003,14,2,0,0.875,348,238,110,6.9,0.1,6.9,2.1,4.9,9,7,0,381,346,35
New Orleans Saints,2003,8,8,0,0.5,340,326,14,0.9,-1.1,-0.3,0.1,-0.4,9,7,0,432,388,44
New York Giants,2003,4,12,0,0.25,243,387,-144,-9,0.4,-8.6,-4.8,-3.7,10,6,0,320,279,41
New York Jets,2003,6,10,0,0.375,283,299,-16,-1,0.4,-0.6,-1.9,1.3,9,7,0,359,336,23
Oakland Raiders,2003,4,12,0,0.25,270,379,-109,-6.8,1.3,-5.5,-4.2,-1.3,11,5,0,450,304,146
Philadelphia Eagles,2003,12,4,0,0.75,374,287,87,5.4,-1,4.4,2.9,1.5,12,4,0,415,241,174
Pittsburgh Steelers,2003,6,10,0,0.375,300,327,-27,-1.7,0.6,-1.1,-2.5,1.4,10,5,1,390,345,45
San Diego Chargers,2003,4,12,0,0.25,313,441,-128,-8,1.2,-6.8,-0.6,-6.2,8,8,0,333,367,-34
San Francisco 49ers,2003,7,9,0,0.438,384,337,47,2.9,0.1,3.1,3,0.1,10,6,0,367,351,16
Seattle Seahawks,2003,10,6,0,0.625,404,327,77,4.8,-0.7,4.1,3.6,0.5,7,9,0,355,369,-14
St. Louis Rams,2003,12,4,0,0.75,447,328,119,7.4,-1.6,5.9,6,-0.2,7,9,0,316,369,-53
Tampa Bay Buccaneers,2003,7,9,0,0.438,301,264,37,2.3,-0.7,1.6,-2.9,4.5,12,4,0,346,196,150
Tennessee Titans,2003,12,4,0,0.75,435,324,111,6.9,-0.5,6.5,7,-0.5,11,5,0,367,324,43
Washington Redskins,2003,5,11,0,0.313,287,372,-85,-5.3,-0.4,-5.7,-1.9,-3.8,7,9,0,307,365,-58